#########################
#.....P.............E...#
###P....SSSS####E.......#
#...####SSSS..E....##E..#
#..P....SSSS####........#
###..P............E..E..#
#########################