#########################
#.....P.............E...#
###P........####E.......#
#...####......E....##E..#
#..P........####........#
###..P............E..E..#
#########################