#########################
#...................E...#
###P........####........#
#...####...........##E..#
#..P........####........#
###..P...............E..#
#########################