#########################
#.......................#
###.........####........#
#...####...........##...#
#...........####........#
###.....................#
#########################