###################################
#..............###................#
#..######..................#####..#
#..............####...............#
#....#####..................###...#
#...............###...............#
#..###.................#####......#
#..................###............#
#......######.....................#
#.......................####......#
#..#####......................###.#
#................###..............#
#...........#####.................#
#.......................#####.....#
###.........................###...#
#...............####..............#
#.................................#
#......#####...............#####..#
#................###..............#
#...####......................##..#
#.......................###.......#
#........#####....................#
#.....................#####.......#
###.........................###...#
#...............###...............#
#..######.........................#
#.....................####........#
#.....#####.......................#
#................###..............#
#..####....................#####..#
#.......................###.......#
#.........#####...................#
#.................................#
###################################
